11111111111111111
11111111111111111
11111111111111111
11111111111111111
11111111111111111
11111111111111111
11111111111111111
11111111111111111
11111111111111111
11111111111111111
11111111111111111
11111111111111111
11111111111111111
11111100000001111
11111011101110111
11111011101110111
11111011101110111
00000000031110111
11111011101110111
11111011101110111
11111011101110111
11111000001002111
11111011101111111
11111011101111111
11111011101111111
11111000001111111
11111111111111111
11111111111111111
11111111111111111
11111111111111111
11111111111111111
11111111111111111
11111111111111111
11111111111111111
11111111111111111
11111111111111111
11111111111111111
