11111111111111111
11111111111111111
11111111111111111
11111111111111111
11111111111111111
11111111111111111
11111111111111111
11111111111111111
11111111111111111
11111111111111111
11111111111111111
11111111111111111
11111111111111111
11111200020002111
11111011101110111
11111011101110111
11111011101110111
00000300001110111
11111011101110111
11111011101110111
11111011101110111
11111200020002111
11111011101111111
11111011101111111
11111011101111111
11111000001111111
11111111111111111
11111111111111111
11111111111111111
11111111111111111
11111111111111111
11111111111111111
11111111111111111
11111111111111111
11111111111111111
11111111111111111
11111111111111111
