11111111111111111
11111111111111111
11111111111111111
11111111111111111
11111111111111111
11111111111111111
11111111111111111
11111111111111111
11111111111111111
11111111111111111
11111111111111111
11111111111111111
11111111111111111
11111000102002111
11111011101110111
11111011101110111
11111011131110111
00000000001110111
11111011101110111
11111011101110111
11111011101110111
11111000002002111
11111011101111111
11111211101111111
11111011101111111
11111000001111111
11111111111111111
11111111111111111
11111111111111111
11111111111111111
11111111111111111
11111111111111111
11111111111111111
11111111111111111
11111111111111111
11111111111111111
